NO ./images/n.xpm
SO ./images/south.xpm
EA ./images/e.xpm
WE ./images/west.xpm

C 0,0,0
F 255,255,255

             1111111111
           111100000001111111
          1110000000000000001111
        11100000N0011111111111111
        11000011111100000000011111
  1111111000011    100000000000111
 11100111100011111111111111111111
 111000111000001111111111111111
 11100011100000000111111111111111
 110000111000000000000000000000111
 110000111000000000000000000000111
 110000111000000000000000000000111
 110000111000000000000000000000111
  1100111000000000000000000000111
   1111110000000111111110000111
        11000000111 111000111
        11000000111 111000111
        111000111   11111111
         1111111
