NO ./images/north_labyrinth.xpm
SO ./images/south_labyrinth.xpm
WE ./images/west_labyrinth.xpm
EA ./images/east_labyrinth.xpm

C 0,0,0
F 77,77,75

     111111111111111111111111
     111111000000000000000001
     100000011111011111111111
111111111110011111110001
11000011111011  11111101
111011111000111110000001
101010101010101010101011
110010010010010010010011111111111111111111111111111111111111111111111111111111111111111111111111111
111011011011011011011010000000000000000000000000000000000000000000000000000000000000000000000000001
110000011000011000011001111111111111111111111111111111111111111111111111111111111111111111111111101
111111011111011111011111                                                                        101
100000000000000000000001                                                                        1N1
101110111011101110111101                                                                        111
101 101 101 101 101  101
111 111 111 111 111  111
