NO ./images/north_labirynth.xpm
SO ./images/south_labirynth.xpm
WE ./images/west_labirynth.xpm
EA ./images/east_labirynth.xpm

C 0,0,0
F 77,77,75

    1111111111 111  11111111
11111000000001 101  100000011
1001000000011111011 1100001011
100000100000000000111000001011
1100110000111000011100010010011
1100000111000000010000000001001
11110000000000000000000000011111
11000000000000101010101100000111
11000000100000000000001000001111
 11111110101111111100000000000111
  1000000000000001110000000001111
 11000000000W00011100000000111111
11111111111111111111111111111111111111
