NO ./images/north_labirynth.xpm
SO ./images/south_labirynth.xpm
WE ./images/west_labirynth.xpm
EA ./images/east_labirynth.xpm

C 0,0,0
F 77,77,75

     111111111111111111111111
     111111000000000000000001
     100000011111011111110111
111110111110011111110001
110000111110111111111101
111011111000111110000001
101010101010101010101011
110010010010010010010011
111011011011011011011011
110000011000011000011001
111111011111011111011111
1000000N0000000000000001
101110111011101110111101
101 101 101 101 101  101
111 111 111 111 111  111


lama
