NO ./images/n.xpm
SO ./images/south.xpm
EA ./images/e.xpm
WE ./images/west.xpm

C 0,0,0
F 255,255,255

1111111111111111111111
1000000000000000000001
1000000000000000000001
1000000000000000000001
1000000000000000000001
1000000000000000000001
10000000000000000S0011
1000000000000000000101
1111111111111111111111
