NO ./images/north.xpm
SO ./images/south.xpm
WE ./images/west.xpm
EA ./images/east.xpm

F 58,157,35
C 119,181,254

        1111111111111111111111111
        100000000011000000000000111111111
        101100000111000000000000000000001
        100100000000000000000000111110111
111111111011000001110000000000001   101
100000000011000001110111111111111   101
11110111111111011100000010001       101
11110111111111011101010000001       101
11000000110101011100000010001       101
10001000000000001100000011011       101
100000000000000011010100100011111111101
11000001110101011111011110N000000000001
11110111 1110101 1011110100011111111111
11111111 1111111 111111111111
