1111111111
1E10000001
10000C0001
1010111111
100P000001
1111111111
