1111111111
1E00000001
10000C0001
1010111111
100P000001
1111111111
