1111111111
1C100000P1
10001C1001
1010111111
11000000E1
1111111111
