11111111111
10P00001001
10000100001
11C01100001
10000100111
10000000001
11111111111
