1111111111
1E1000C001
10C0000001
1010111111
100P000001
1111111111
