1111111111111111111
10000000000000000E1
1000000111110000001
100000C0011111C1111
1000000000000010001
1111100011111111111
100000000000C000001
1000000000000000001
1000000000000000001
1000C11111111111111
1110000000000000111
1000000000000000001
1111100000000000001
1C10000000000000001
1000000000001111111
1000000000000000001
10000000000000C0001
1000000000000011111
10000000000000000P1
1111111111111111111
