1111111111
1C10000001
100C1C1001
1010111111
110P0000E1
1111111111
