1111111111111111111
1000E00000000010001
1000000001100010001
111000C000100000001
1000111111100C00001
1111100000P00000111
1111111111111111111
