111111111111111111111111111111111111111111
1P0000010000000000000000000000000000000001
100001000000000000000000000000000000000001
11C011000011000000000C00000000011100000001
100001001100000000001110000000000000000001
1E000000000000000000000000000000000C000001
100000000000000000000000000000000000000001
100000000000000000000000000000000000000011
111111111111111111111111111111111111111111
