111111111111111111111111111111
1111100011111100000000000001C1
1010000000000000000C0111000001
1E1000000000000000000000000001
100000000000000000000000000111
100000000000000000000000000001
1000C11111111111111100000000P1
111111111111111111111111111111
