111111111111111111111111111111
1P0000111111111111111111111111
110110011111111111111111111111
111111011111111111111111111111
111C00011111111111111111111111
111000000111111111111111111111
110000000001111111111111111111
110000001011011111111111111111
111100001010111111111111111111
111110001011011111111111111111
111111001010111111111111111111
101010101010111111111111111111
10010C010010111111111111111111
100010110111111111111111111111
1E0000000111111111111111111111
111111111111111111111111111111
